Ss, Ss, Ss, Ss, Ss, Ss, Ss, Ss, Ss, Ss, Gg, Ss, Wwg, Wwg, Rp, Gg, Gg, Ss, Ss, Ss, Cm, Ss, Ss, Ss, Ss
Ss, Ss, Ss, Wwg, Sm, Ss, Ss, Ss, Wwf, Gg, Wwg, Wwf, Wwg, Wwg, Rp, Wwf, Sm, Ss, Wwf, Chw, 2 Km, Cm, Gg, Ss, Ss
Wwg, Ss, Wwg, Ss, Ss, Wwg, Ss, Wwg, Sm, Sm, Wwg, Ss, Ww^Vm, Wwf, Ss, Wwg, Sm, Sm, Sm, Cm, Chw, Chw, Wwg, Ss, Ss
Ss, Wwg, Ss, Ww^Vm, Wwg, Wwg, Sm, Ss^Vhs, Ss, Ss, Ss, Ss, Wwg, Ss, Ss, Ss, Wwg, Ww^Vm, Wwf, Wwg, Wwg, Wwf, Sm, Ss, Ss
Ss, Ss, Ss, Ss, Wwf, Gg, Wwf, Wwg, Wwg, Ss^Vhs, Ss, Ss, Wwg, Ss^Vhs, Wwg, Wwg, Ss, Rp, Wwf, Ss, Ss, Wwg, Ss, Ss, Ss
Ss, Ss, Ss^Vhs, Gg, Gg, Wwf, Ss, Wwg, Ss, Sm, Sm, Wwg, Ww^Vm, Wwg, Ss, Ss, Wwf, Rp, Ss, Gg, Wwf, Ww^Vm, Wwg, Ss, Wwg
Ss, Ss, Gg, Gg, Ss, Wwf, Wwf, Ss, Wwg, Sm, Ss, Wwg, Wwg, Ss, Ss, Ss, Ss, Wwg, Ss, Gg, Gg, Ss, Sm, Wwg, Ss
Ss, Ss, Ss, Sm, Ss, Ss, Ss, Ss, Ss, Ss, Ss, Wwg, Ss, Ss, Wwf, Rp, Wwg, Sm, Ww^Vm, Ss, Ss, Ss, Sm, Ss, Ss
Ss, Ss, Ss, Wwg, Wwf, Gg, Wwg, Ss, Ss, Ss, Wwf, Ww^Vm, Wwf, Wwf^Vhs, Ss, Rp, Ss, Sm, Wwg, Sm, Sm, Sm, Ss^Vhs, Ss, Ss
Ss, Ss, Ss, Wwf, Gg, Ss, Ss, Ss, Ss, Ss, Wwf, Wwg, Sm, Sm, Ss, Wwf, Gg, Ss, Ss, Ss, Ss, Ss, Ss, Ss, Wwg
Wwg, Ss, Wwg, Ss, Wwg, Ss^Vhs, Wwg, Ss, Ss, Ss, Rp, Wwg, Wwg, Sm, Sm, Ss, Ss, Gg, Wwf, Gg, Ss, Ss, Wwg, Wwg, Ss
Ss, Wwg, Ss, Ww^Vm, Ss, Wwg, Ss, Wwg, Wwg, Wwg, Sm, Ss, Wwg, Wwg, Wwg, Wwg, Wwg, Wwg, Wwg, Wwf, Wwg, Wwg, Ss, Ss, Ss
Ss, Ss, Ss, Ss, Ss, Ss, Ss, Ss, Rp, Sm, Sm, Wwg, Wwg, Ss, Ss, Ss, Gg, Wwf, Ss, Wwg, Sm, Ss, Ss^Vhs, Ss, Ss
Ss, Ss^Vhs, Ss, Ss, Ss, Ss, Ss, Ss, Wwf, Ss, Sm, Sm, Wwg, Ss, Ss, Ss, Ss, Gg, Ss, Ss, Sm, Ss, Ss, Ss, Ss
Ss, Ss, Ss, Ss, Sm, Ww^Vm, Sm, Rp, Ss, Wwg, Ss, Ww^Vm, Ss^Vhs, Ss, Ss, Sm, Sm, Wwf, Sm, Sm, Sm, Sm, Wwf, Ss, Ss
Ss, Ss, Ss, Sm, Cme, Cme, Cme, Ss, Ss, Ss, Ss, Wwg, Ss, Ss, Gg, Ss, Wwg, Sm, Gg, Wwg, Sm, Sm, Gg, Gg, Gg
Ss, Ss, Ss, Wwg, Cme, 1 Kme, Cme, Sm, Ss, Ss, Ss, Wwg, Ss, Ss, Ss, Wwf, Wwf, Ss^Vhs, Ss, Ss, Ss, Ss, Gg, Gg, Gg
Ss, Ss, Ss, Ss, Ss, Cme, Ss, Ss, Ss, Ss, Ss, Wwg, Ss, Ss, Ss, Ss, Ss, Ss, Ss, Ss, Ss, Ss, Ss, Gg, Gg
Ss, Ss, Ss, Ss, Ss, Ss, Ss, Ss, Ss, Ss, Ss, Wwg, Ss, Ss, Ss, Ss, Ss, Ss, Ss, Ss, Ss, Ss, Ss, Gg, Gg
